1111111111111111111111111111111111111
10010000000C011111111111C111111111111
1000C11111000000000000000011111111111
1P0011C000000C010000111110011111111C1
10000111110000011000111110000111111C1
10000111110000011100000000000111111C1
1000011111000001111111100011111111CC1
100011E0000000C1111111C011111111111C1
1000011111000001110000011111111111CC1
101111C00000000111C000000000000000CC1
1000C0011100000000C111000011111111C11
1111111111111111111111111111111111111