111111111111
110100000001
100001111101
1PE011100001
10M001111101
100111110001
100C01111101
101111100001
111111111111